4
0 4 0 40 1 4
4 8 0 25 1 4
8 16 0 25 1 4
16 30 0 40 1 4
30
256 192 320 192 0 1 1 0
320 192 320 352 0 1 1 90
320 352 224 320 0 1 1 0
224 320 256 192 0 1 1 90
384 352 448 352 0 1 1 0
448 352 448 416 0 1 1 90
448 416 384 416 0 1 1 0
384 416 384 352 0 1 1 90
448 256 480 288 0 1 1 45
480 288 512 288 0 1 1 0
512 288 544 256 0 1 1 45
544 256 544 224 0 1 1 90
544 224 512 192 0 1 1 45
512 192 480 192 0 1 1 0
480 192 448 224 0 1 1 45
448 224 448 256 0 1 1 90
64 160 96 160 0 1 1 0
96 160 96 192 0 1 1 90
96 192 128 192 0 1 1 0
128 192 160 192 0 1 1 0
160 192 192 224 0 1 1 45
192 224 192 256 0 1 1 90
192 256 160 288 0 1 1 45
160 288 128 288 0 1 1 0
128 288 96 320 0 1 1 0
96 320 32 320 0 1 1 90
32 320 32 256 0 1 1 0
32 256 64 224 0 1 1 90
64 224 64 192 0 1 1 90
64 192 64 160 0 1 1 90

288 48 30 0 0
